99 99 99 99 99 99 99 99 99 99 99 99 99 99 99 99 99 99 99 99 99 99 99 99 99 99 99 99 99 99 99 99 99 99 99 99 99 99 99 99 99 99 99 99 99 99 99 99 99 99 99 99 99 99 99 99 99 99 0
99 99 99 99 99 99 99 99 99 99 99 99 99 99 99 99 99 99 99 99 99 99 99 99 99 99 99 99 99 99 99 99 99 99 99 99 99 99 99 99 99 99 99 99 99 99 99 99 99 99 99 99 99 99 99 99 99 99 0
99 99 99 99 99 99 99 99 99 99 99 99 99 99 99 99 99 99 99 99 99 99 99 99 99 99 99 99 99 99 99 99 99 99 99 99 99 99 99 99 99 99 99 99 99 99 99 99 99 99 99 99 99 99 99 99 99 99 0
99 99 99 99 99 99 99 99 99 99 99 99 99 99 99 99 99 99 99 99 99 99 99 99 99 99 99 99 99 99 99 99 99 99 99 99 99 99 99 99 99 99 99 99 99 99 99 99 99 99 99 99 99 99 99 99 99 99 0
99 99 99 99 99 99 99 99 99 99 99 99 99 99 99 99 99 99 99 99 99 99 99 99 99 99 99 99 99 99 99 99 99 99 99 99 99 99 99 99 99 99 99 99 80 99 99 99 99 99 99 99 99 99 99 99 99 99 0
99 99 99 99 99 99 99 99 99 99 99 99 99 99 99 99 99 99 99 99 99 99 99 99 99 99 99 99 99 99 99 99 99 99 99 99 99 99 99 99 99 99 99 99 99 99 99 99 99 99 99 99 99 99 99 99 99 99 0
99 99 99 99 99 99 99 99 99 99 99 99 99 99 99 99 99 99 99 99 99 99 99 99 99 99 99 99 99 99 99 99 99 99 99 99 99 99 99 99 99 99 99 99 99 99 99 99 99 99 99 99 99 99 99 99 99 99 0
99 99 99 99 99 99 99 99 99 99 99 99 99 99 99 99 99 99 99 99 99 99 99 99 99 99 99 99 99 99 99 99 99 99 99 99 99 99 99 99 99 99 99 99 99 99 99 99 99 99 99 99 99 99 99 99 99 99 0
99 99 99 99 99 99 99 99 99 99 99 99 99 99 99 99 99 99 99 99 99 99 99 99 99 99 99 99 99 99 99 99 99 99 99 99 99 99 99 99 99 99 99 99 99 99 99 99 99 99 99 99 99 99 99 99 99 99 0
99 99 99 99 99 99 99 99 99 99 99 99 99 99 99 99 99 99 99 99 99 99 99 99 99 99 99 99 99 99 99 99 99 99 99 99 99 99 99 99 99 99 99 99 99 99 99 99 99 99 99 99 99 99 99 99 99 99 0
99 99 99 99 99 99 99 99 99 99 99 99 99 99 99 99 99 99 99 99 99 99 99 99 99 99 99 99 99 99 99 99 99 99 99 99 99 99 99 99 99 99 99 99 99 99 99 99 99 99 99 99 99 99 99 99 99 99 0
99 99 99 99 99 99 99 99 99 99 99 99 99 99 99 99 99 99 99 99 99 99 99 99 99 99 99 99 99 99 99 99 99 99 99 99 99 99 99 99 99 99 99 99 99 99 99 99 99 99 99 99 99 99 99 99 99 99 0
99 99 99 99 99 99 99 99 99 99 99 99 99 99 99 99 99 99 99 99 99 99 99 99 99 99 99 99 99 99 99 99 99 99 99 99 99 99 99 99 99 99 99 99 99 99 99 99 99 99 99 99 99 99 99 99 99 99 0
99 99 99 99 99 99 99 99 99 99 99 99 99 99 99 99 99 99 99 99 99 99 99 99 99 99 99 99 99 99 99 99 99 99 99 99 99 99 99 99 99 99 99 99 99 99 99 99 99 99 99 99 99 99 99 99 99 99 0
99 99 99 99 99 99 99 99 99 99 99 99 99 99 99 99 99 99 99 99 99 99 99 99 99 99 99 99 99 99 99 99 99 99 99 99 99 99 99 99 99 99 99 99 99 99 99 99 99 99 99 99 99 99 99 99 99 99 0
99 99 99 99 99 99 99 99 99 99 99 99 99 99 99 99 99 99 99 99 99 99 99 99 99 99 99 99 99 99 99 99 99 99 99 99 99 99 99 99 99 99 99 99 99 99 99 99 99 99 99 99 99 99 99 99 99 99 0
99 99 99 99 99 99 99 99 99 99 99 99 99 99 99 99 99 99 99 99 99 99 99 99 99 99 99 99 99 99 99 99 99 99 99 99 99 99 99 99 99 99 99 99 99 99 99 99 99 99 99 99 99 99 99 99 99 99 0
99 99 99 99 99 99 99 99 99 99 99 99 99 99 99 99 99 99 99 99 99 99 99 99 99 99 99 99 99 99 99 99 99 99 99 99 99 99 99 99 99 99 99 99 99 99 99 99 99 99 99 99 99 99 99 99 99 99 0
99 99 99 99 99 99 99 99 99 99 99 99 99 99 99 99 99 99 99 99 99 99 99 99 99 99 99 99 99 99 99 99 99 99 99 99 99 99 99 99 99 99 99 99 99 99 99 99 99 99 99 99 99 99 99 99 99 99 0
99 99 99 99 99 99 99 99 99 99 99 99 99 99 99 99 99 99 99 99 99 99 99 99 99 99 99 99 99 99 99 99 99 99 99 99 99 99 99 99 99 99 99 99 99 99 99 99 99 99 99 99 99 99 99 99 99 81 0
99 99 99 99 99 99 99 99 99 99 99 99 99 99 99 99 99 99 99 99 99 99 99 99 99 99 99 99 99 99 99 99 99 99 99 17 18 18 19 99 99 99 99 17 18 18 18 18 18 18 18 18 19 99 99 99 15 12 0
99 99 99 99 99 99 99 99 99 99 99 99 99 99 99 99 99 99 99 99 99 99 99 99 99 99 99 99 99 99 99 99 99 99 99 20 14 14 22 99 99 99 99 20 14 14 14 14 14 14 14 34 25 99 99 99 20 14 0
99 99 99 99 99 99 99 99 99 99 99 99 99 99 99 99 99 99 99 99 99 99 99 99 99 99 99 99 99 99 99 23 99 99 99 20 14 14 22 99 99 99 99 20 14 14 14 14 14 14 14 22 99 99 99 17 31 14 0
99 99 99 99 99 99 99 99 99 99 99 99 99 99 99 99 99 99 99 99 99 99 99 99 99 99 99 23 99 99 99 24 99 99 99 20 14 14 22 99 99 99 99 20 14 14 14 14 14 14 34 25 99 99 99 20 14 14 0
99 99 99 99 99 99 99 99 99 99 99 99 99 99 99 99 99 99 99 99 99 99 99 99 99 99 17 22 99 99 99 20 18 18 18 31 14 14 22 99 99 99 99 20 14 14 14 34 27 27 25 99 99 99 17 31 14 14 0
99 99 99 99 99 99 99 99 99 99 99 99 99 99 99 99 99 99 99 99 99 99 99 99 99 17 31 22 99 99 99 20 14 14 14 14 14 14 22 99 99 99 99 20 14 14 14 22 79 99 99 99 99 99 20 14 14 14 0
99 99 99 81 99 99 99 99 99 99 99 99 99 99 99 99 99 99 99 82 99 82 99 99 17 31 14 22 99 99 99 20 14 14 14 14 14 14 22 99 99 99 99 20 14 14 14 22 99 99 99 99 99 99 20 14 14 14 0
11 12 12 12 12 13 18 18 18 18 19 51 51 51 51 51 17 18 11 12 12 12 13 18 31 14 14 22 51 51 51 20 14 14 14 14 14 14 22 99 99 99 99 20 14 14 14 22 99 99 99 99 17 18 31 34 27 27 0
14 14 14 14 14 14 14 14 14 14 22 52 52 52 52 52 20 14 14 14 14 14 14 14 14 14 14 22 52 52 52 20 14 14 14 14 14 14 22 99 99 99 99 20 14 14 14 22 99 99 99 99 26 27 27 25 79 99 0
14 14 14 14 14 14 14 14 14 14 22 52 52 52 52 52 20 14 14 14 14 14 14 14 14 14 14 22 52 52 52 20 14 14 14 14 14 14 22 99 99 99 99 20 14 14 14 22 99 99 99 99 99 79 99 99 99 99 0
14 14 14 14 14 14 14 14 14 14 22 52 52 52 52 52 20 14 14 14 14 14 14 14 14 14 14 22 52 52 52 20 14 14 14 14 14 14 22 99 99 99 99 20 14 14 14 22 99 99 99 99 99 99 99 99 99 99 0
14 14 14 14 14 14 14 14 14 14 22 52 52 52 52 52 20 14 14 14 14 14 14 14 14 14 14 22 52 52 52 20 14 14 14 14 14 14 22 99 99 99 99 20 14 14 14 32 19 99 99 99 99 99 99 99 99 99 0
14 14 14 14 14 14 14 14 14 14 32 18 18 18 18 18 31 14 14 14 14 14 14 14 14 14 14 32 18 18 18 31 14 14 14 14 14 14 32 18 18 18 18 31 14 14 14 14 32 18 18 18 18 18 18 18 18 18 0
